111111
1PE1C1
111101
100001
111111

