1111111111111
1C010000000C1
1001011111101
1P0001E000001
1111111111111