1111111111111
100P0000E00C1
1000000000001
1111111111111