1111111111111111111111111111111111111
1000010000000000000000000000000000001
1000010000000000000000000000000000001
1111110000000000000000000000000000001
1000100010111110111110111110110110001
1000100010100010001000001000101010001
100C11111C11111C00100C00100C10001C0P1
1000100010100010001000001000100010001
1000100010100010001000111110100010001
1000000000000000000000000000000000001
10000000000000000000000000000000000E1
10000000000000000C0000000000000000001
1111111111111111111111111111111111111